+=======================+
|.......................|
|.......................|
|.......................|
|.......................|
|.[====]................|
|.[""""]................|
|.[""""]................|
|.[=#==]................|
|.......................|
|.............[======]..|
|.............[""""""]..|
|.............[""""""]..|
|.............[""""""]..|
|.............[""""""]..|
|.............[""""""]..|
|.............["""#""]..|
|.......................|
|.......................|
+=======================+